{
"description": "Moon Mission",
"gravity": 1.62,
"scale": 0.8,
"xvelocity": 50,
"yvelocity": 10,
"xdistance": -32,
"ydistance": 0,
"rotate": 18,
"terrain": [
        400,380,340,300,150,100,100,100,145,142,
        135,130,120,80,60,40,20,20,20,20,
        60,70,80,115,115,115,130,132,140,160,
        210,225,

        220,180,180,140,120,70,60,70,80,100,
        95,80,85,60,50,20,20,20,50,60,
        80,90,95,87,85,100,190,200,200,200,
        290,390,420
        ]
}
