{
"description": "Moon Mission",
"gravity": 1.62,
"scale": 0.8,
"xvelocity": 50,
"yvelocity": 10,
"xdistance": -32,
"ydistance": 0,
"rotate": 18,
"terrain": [
        340,350,340,300,150,100,100,140,145,142,
        135,130,120,80,60,30,10,10,10,10,
        60,105,110,115,120,122,130,132,140,160,
        210,225,

        220,200,200,140,120,70,60,70,50,50,
        50,80,85,60,50,20,20,20,50,60,
        80,90,95,87,85,100,190,200,200,200,
        290,390,420
        ]
}
